60 20
############################################################
############################################################
######________________________________________________######
####____________________________________________________####
####____________________________________________________####
###______________________________________________________###
###______________________________________________________###
###_________####################################_________###
##_________######################################_________##
##_________######################################_________##
##_________######################################_________##
##_________######################################_________##
###_________####################################_________###
###________________________=_____________________________###
###________________________=_____________________________###
####_______________________=__C_________________________####
####_______________________=____________________________####
######_____________________=__________________________######
############################################################
############################################################